Term,TF,DF,IDF,TF-IDF,Total Dokumen Sentimen Positive,Total Sentimen Negative
ikhtiar,1,1,3.22994,3.22994,1,0
hadap,1,13,2.11599,2.11599,7,6
kemarau,1,10,2.22994,2.22994,5,5
gelar,1,62,1.43755,1.43755,51,11
minta,1,34,1.69846,1.69846,8,26
hujan,1,10,2.22994,2.22994,4,6
panas,1,9,2.27570,2.2757,1,8
bikin,1,5,2.53097,2.53097,2,3
manfaat,1,3,2.75282,2.75282,2,1
cahaya,1,1,3.22994,3.22994,0,1
matahari,1,1,3.22994,3.22994,0,1
asak,1,1,3.22994,3.22994,0,1
nyata,1,10,2.22994,2.22994,2,8
matang,1,1,3.22994,3.22994,0,1
tewas,1,59,1.45909,1.45909,0,59
nilai,1,3,2.75282,2.75282,2,1
menang,1,19,1.95118,1.95118,13,6
mahal,1,13,2.11599,2.11599,0,13
hilang,1,4,2.62788,2.62788,0,4
edar,1,7,2.38484,2.38484,0,7
siasat,1,1,3.22994,3.22994,0,1
temu,1,48,1.54870,1.5487,8,40
serah,1,13,2.11599,2.11599,4,9
uang,1,12,2.15076,2.15076,5,7
ketua,1,14,2.08381,2.08381,2,12
periksa,1,22,1.88752,1.88752,2,20
kait,1,6,2.45179,2.45179,0,6
peras,1,8,2.32685,2.32685,0,8
pimpin,1,15,2.05385,2.05385,5,10
peran,1,2,2.92891,2.92891,0,2
usul,1,2,2.92891,2.92891,2,0
pilih,1,10,2.22994,2.22994,8,2
sepakat,1,2,2.92891,2.92891,2,0
indra,1,14,2.08381,2.08381,8,6
damping,1,4,2.62788,2.62788,3,1
metro,1,4,2.62788,2.62788,0,4
saksi,1,17,1.99949,1.99949,1,16
duga,1,35,1.68587,1.68587,0,35
fakta,1,5,2.53097,2.53097,1,4
pernah,1,5,2.53097,2.53097,2,3
kasus,1,50,1.53097,1.53097,0,50
lompat,1,3,2.75282,2.75282,0,3
buka,1,43,1.59647,1.59647,36,7
relawan,1,10,2.22994,2.22994,10,0
juang,1,1,3.22994,3.22994,1,0
dukung,1,18,1.97467,1.97467,17,1
aman,1,25,1.83200,1.832,20,5
intensif,1,2,2.92891,2.92891,1,1
koordinasi,1,1,3.22994,3.22994,1,0
gera,1,4,2.62788,2.62788,4,0
pangan,1,9,2.27570,2.2757,6,3
murah,1,10,2.22994,2.22994,10,0
bagi,1,31,1.73858,1.73858,25,6
gratis,1,15,2.05385,2.05385,15,0
dagang,1,29,1.76754,1.76754,12,17
pakai,1,7,2.38484,2.38484,3,4
tuju,1,4,2.62788,2.62788,2,2
tutup,1,6,2.45179,2.45179,2,4
teman,1,7,2.38484,2.38484,3,4
bantah,1,8,2.32685,2.32685,0,8
bakar,1,33,1.71142,1.71142,5,28
belum,1,24,1.84973,1.84973,4,20
padam,1,6,2.45179,2.45179,0,6
tan,1,4,2.62788,2.62788,2,2
gaet,1,4,2.62788,2.62788,4,0
pan,1,2,2.92891,2.92891,2,0
pesta,1,3,2.75282,2.75282,2,1
sepi,1,3,2.75282,2.75282,0,3
klub,1,1,3.22994,3.22994,0,1
patungan,1,1,3.22994,3.22994,0,1
panggil,1,7,2.38484,2.38484,1,6
jaya,1,1,3.22994,3.22994,0,1
layan,1,9,2.27570,2.2757,9,0
kendali,1,3,2.75282,2.75282,2,1
tumbuh,1,7,2.38484,2.38484,7,0
duduk,1,6,2.45179,2.45179,6,0
rawan,1,3,2.75282,2.75282,0,3
jual,1,25,1.83200,1.832,11,14
apar,1,1,3.22994,3.22994,0,1
naik,1,46,1.56718,1.56718,16,30
lopor,1,2,2.92891,2.92891,2,0
laju,1,1,3.22994,3.22994,1,0
tulis,1,1,3.22994,3.22994,1,0
komitmen,1,1,3.22994,3.22994,1,0
anti,1,5,2.53097,2.53097,3,2
korupsi,1,3,2.75282,2.75282,2,1
pecah,1,6,2.45179,2.45179,4,2
rekor,1,4,2.62788,2.62788,3,1
berkah,1,8,2.32685,2.32685,8,0
dingin,1,2,2.92891,2.92891,1,1
laris,1,4,2.62788,2.62788,4,0
darurat,1,4,2.62788,2.62788,2,2
kering,1,7,2.38484,2.38484,2,5
januari,1,1,3.22994,3.22994,0,1
festival,1,11,2.18855,2.18855,11,0
kreasi,1,1,3.22994,3.22994,1,0
bahan,1,10,2.22994,2.22994,4,6
pokok,1,5,2.53097,2.53097,2,3
suhu,1,5,2.53097,2.53097,1,4
siang,1,4,2.62788,2.62788,3,1
waspada,1,11,2.18855,2.18855,1,10
papar,1,1,3.22994,3.22994,0,1
sinar,1,1,3.22994,3.22994,0,1
terik,1,1,3.22994,3.22994,0,1
prediksi,1,4,2.62788,2.62788,3,1
indeks,1,2,2.92891,2.92891,1,1
ekstrem,1,3,2.75282,2.75282,1,2
besar,1,11,2.18855,2.18855,8,3
wilayah,1,10,2.22994,2.22994,4,6
keluh,1,6,2.45179,2.45179,0,6
musim,1,6,2.45179,2.45179,5,1
turun,1,20,1.92891,1.92891,3,17
rekap,1,2,2.92891,2.92891,1,1
hasil,1,27,1.79857,1.79857,11,16
dewa,1,3,2.75282,2.75282,2,1
tekuk,1,1,3.22994,3.22994,1,0
sore,1,4,2.62788,2.62788,3,1
kalah,1,6,2.45179,2.45179,0,6
persis,1,5,2.53097,2.53097,0,5
solo,1,43,1.59647,1.59647,2,41
tahan,1,8,2.32685,2.32685,4,4
imbang,1,5,2.53097,2.53097,1,4
kali,1,5,2.53097,2.53097,3,2
landa,1,3,2.75282,2.75282,0,3
zona,1,3,2.75282,2.75282,0,3
aktif,1,3,2.75282,2.75282,0,3
ternak,1,5,2.53097,2.53097,3,2
tolak,1,8,2.32685,2.32685,0,8
relokasi,1,5,2.53097,2.53097,1,4
berat,1,4,2.62788,2.62788,0,4
terjun,1,6,2.45179,2.45179,1,5
seru,1,8,2.32685,2.32685,7,1
versus,1,32,1.72479,1.72479,2,30
unjung,1,5,2.53097,2.53097,4,1
lampau,1,2,2.92891,2.92891,2,0
target,1,13,2.11599,2.11599,10,3
sosialisasi,1,5,2.53097,2.53097,5,0
jelang,1,28,1.78278,1.78278,19,9
saling,1,2,2.92891,2.92891,0,2
sikut,1,1,3.22994,3.22994,0,1
poin,1,1,3.22994,3.22994,0,1
luang,1,1,3.22994,3.22994,1,0
itik,1,1,3.22994,3.22994,1,0
libat,1,11,2.18855,2.18855,1,10
celaka,1,81,1.32145,1.32145,5,76
mud,1,4,2.62788,2.62788,1,3
adu,1,9,2.27570,2.2757,3,6
mulut,1,2,2.92891,2.92891,1,1
rajin,1,5,2.53097,2.53097,4,1
rogok,1,1,3.22994,3.22994,0,1
kocek,1,1,3.22994,3.22994,0,1
sukses,1,10,2.22994,2.22994,10,0
laku,1,86,1.29544,1.29544,7,79
tangkap,1,31,1.73858,1.73858,2,29
operasi,1,6,2.45179,2.45179,2,4
sikat,1,3,2.75282,2.75282,1,2
awat,1,2,2.92891,2.92891,0,2
restorasi,1,1,3.22994,3.22994,0,1
koleksi,1,3,2.75282,2.75282,2,1
rusak,1,9,2.27570,2.2757,2,7
tembus,1,14,2.08381,2.08381,3,11
telur,1,13,2.11599,2.11599,0,13
mulai,1,25,1.83200,1.832,14,11
prakira,1,6,2.45179,2.45179,4,2
cerah,1,3,2.75282,2.75282,3,0
awan,1,2,2.92891,2.92891,2,0
ringan,1,3,2.75282,2.75282,1,2
dampak,1,13,2.11599,2.11599,0,13
serang,1,3,2.75282,2.75282,0,3
diare,1,3,2.75282,2.75282,0,3
keluarga,1,9,2.27570,2.2757,2,7
brigadir,1,1,3.22994,3.22994,1,0
akan,1,19,1.95118,1.95118,8,11
kirim,1,2,2.92891,2.92891,2,0
ham,1,4,2.62788,2.62788,1,3
narkoba,1,8,2.32685,2.32685,0,8
perang,1,8,2.32685,2.32685,8,0
rundung,1,1,3.22994,3.22994,1,0
ajak,1,13,2.11599,2.11599,13,0
kreatif,1,3,2.75282,2.75282,3,0
karya,1,21,1.90772,1.90772,21,0
sakit,1,14,2.08381,2.08381,2,12
tingkat,1,13,2.11599,2.11599,8,5
payung,1,1,3.22994,3.22994,0,1
putih,1,5,2.53097,2.53097,1,4
andang,1,4,2.62788,2.62788,4,0
obesitas,1,1,3.22994,3.22994,1,0
harus,1,18,1.97467,1.97467,12,6
pesona,1,1,3.22994,3.22994,1,0
produk,1,9,2.27570,2.2757,9,0
lestari,1,5,2.53097,2.53097,5,0
budaya,1,14,2.08381,2.08381,14,0
tari,1,6,2.45179,2.45179,6,0
sufi,1,1,3.22994,3.22994,1,0
riah,1,13,2.11599,2.11599,13,0
maulid,1,2,2.92891,2.92891,2,0
nabi,1,2,2.92891,2.92891,2,0
pamer,1,17,1.99949,1.99949,17,0
unggul,1,2,2.92891,2.92891,2,0
seni,1,9,2.27570,2.2757,9,0
tradisional,1,12,2.15076,2.15076,6,6
belanja,1,1,3.22994,3.22994,1,0
dana,1,5,2.53097,2.53097,4,1
miliar,1,11,2.18855,2.18855,7,4
tanam,2,12,2.15076,4.30152,12,0
toga,1,1,3.22994,3.22994,1,0
skor,1,1,3.22994,3.22994,0,1
kendara,1,19,1.95118,1.95118,5,14
tumpuk,1,1,3.22994,3.22994,0,1
ungar,1,5,2.53097,2.53097,2,3
bus,1,4,2.62788,2.62788,1,3
ramal,1,1,3.22994,3.22994,1,0
september,1,3,2.75282,2.75282,1,2
udara,1,3,2.75282,2.75282,3,0
netralitas,1,3,2.75282,2.75282,2,1
kena,1,6,2.45179,2.45179,3,3
sanksi,1,2,2.92891,2.92891,1,1
moral,1,1,3.22994,3.22994,0,1
pecat,1,1,3.22994,3.22994,0,1
kolonel,1,1,3.22994,3.22994,1,0
resmi,1,12,2.15076,2.15076,9,3
jabat,1,6,2.45179,2.45179,3,3
stabil,1,5,2.53097,2.53097,4,1
perintah,1,11,2.18855,2.18855,8,3
salat,1,6,2.45179,2.45179,5,1
mohon,1,2,2.92891,2.92891,1,1
siap,1,37,1.66174,1.66174,33,4
anggar,1,3,2.75282,2.75282,2,1
salur,1,8,2.32685,2.32685,5,3
buang,1,1,3.22994,3.22994,0,1
jenazah,1,8,2.32685,2.32685,0,8
ambang,1,3,2.75282,2.75282,0,3
labuh,1,13,2.11599,2.11599,7,6
bacok,1,3,2.75282,2.75282,0,3
guru,1,12,2.15076,2.15076,6,6
bantu,1,24,1.84973,1.84973,12,12
sosok,1,5,2.53097,2.53097,1,4
mayat,1,23,1.86821,1.86821,0,23
pria,1,15,2.05385,2.05385,3,12
misterius,1,1,3.22994,3.22994,0,1
tanjung,1,9,2.27570,2.2757,6,3
emas,1,11,2.18855,2.18855,8,3
tanpa,1,9,2.27570,2.2757,2,7
identitas,1,6,2.45179,2.45179,1,5
apung,1,1,3.22994,3.22994,0,1
simulasi,1,3,2.75282,2.75282,3,0
normal,1,4,2.62788,2.62788,2,2
borong,1,2,2.92891,2.92891,2,0
sehat,2,14,2.08381,4.16762,14,0
suguh,1,1,3.22994,3.22994,1,0
aneka,1,2,2.92891,2.92891,2,0
fasilitas,1,7,2.38484,2.38484,7,0
nal,1,3,2.75282,2.75282,1,2
senam,1,3,2.75282,2.75282,3,0
tera,1,1,3.22994,3.22994,1,0
olah,1,11,2.18855,2.18855,5,6
raga,1,2,2.92891,2.92891,2,0
usia,1,6,2.45179,2.45179,2,4
tinjau,1,3,2.75282,2.75282,2,1
tinggi,1,16,2.02582,2.02582,9,7
edukasi,1,3,2.75282,2.75282,3,0
gigi,2,3,2.75282,5.50564,2,1
pasta,1,1,3.22994,3.22994,1,0
tanggap,1,2,2.92891,2.92891,2,0
unjuk,1,3,2.75282,2.75282,3,0
maut,1,22,1.88752,1.88752,0,22
sangka,1,24,1.84973,1.84973,0,24
semester,1,2,2.92891,2.92891,0,2
partai,1,6,2.45179,2.45179,4,2
buruh,1,5,2.53097,2.53097,0,5
dongeng,1,1,3.22994,3.22994,1,0
islami,1,1,3.22994,3.22994,1,0
beda,1,3,2.75282,2.75282,1,2
lari,1,5,2.53097,2.53097,1,4
respon,1,1,3.22994,3.22994,1,0
dekat,1,4,2.62788,2.62788,3,1
logistik,1,1,3.22994,3.22994,1,0
genjot,1,5,2.53097,2.53097,5,0
terima,1,19,1.95118,1.95118,11,8
faktor,1,3,2.75282,2.75282,1,2
geografis,1,1,3.22994,3.22994,1,0
rela,1,6,2.45179,2.45179,6,0
jemput,1,3,2.75282,2.75282,3,0
kompas,1,1,3.22994,3.22994,1,0
desember,1,1,3.22994,3.22994,1,0
catat,1,2,2.92891,2.92891,2,0
tanggal,1,3,2.75282,2.75282,2,1
super,1,1,3.22994,3.22994,0,1
henti,1,2,2.92891,2.92891,0,2
korban,1,73,1.36661,1.36661,2,71
kronologi,1,28,1.78278,1.78278,0,28
rem,1,6,2.45179,2.45179,0,6
blong,1,6,2.45179,2.45179,0,6
lampung,1,1,3.22994,3.22994,0,1
selamat,1,26,1.81496,1.81496,18,8
tabrak,1,68,1.39743,1.39743,4,64
motor,1,19,1.95118,1.95118,5,14
luka,2,8,2.32685,4.6537,0,8
lengkap,1,6,2.45179,2.45179,2,4
kondisi,1,15,2.05385,2.05385,4,11
kini,1,11,2.18855,2.18855,2,9
keras,1,11,2.18855,2.18855,2,9
belas,1,3,2.75282,2.75282,1,2
ledak,1,7,2.38484,2.38484,0,7
akses,1,2,2.92891,2.92891,0,2
masuk,1,9,2.27570,2.2757,6,3
sampah,1,5,2.53097,2.53097,3,2
usaha,1,15,2.05385,2.05385,7,8
api,1,38,1.65015,1.65015,3,35
salip,1,1,3.22994,3.22994,0,1
bangkit,1,3,2.75282,2.75282,3,0
tangki,1,6,2.45179,2.45179,1,5
siaga,1,3,2.75282,2.75282,1,2
asap,1,3,2.75282,2.75282,0,3
tambang,1,2,2.92891,2.92891,0,2
ilegal,1,8,2.32685,2.32685,0,8
marak,1,6,2.45179,2.45179,3,3
legalitas,1,1,3.22994,3.22994,0,1
pejal,1,1,3.22994,3.22994,0,1
kaki,1,2,2.92891,2.92891,0,2
jaga,1,14,2.08381,2.08381,11,3
piala,1,5,2.53097,2.53097,4,1
bayar,1,2,2.92891,2.92891,0,2
seleksi,1,5,2.53097,2.53097,4,1
tangkal,1,2,2.92891,2.92891,1,1
radikalisme,1,1,3.22994,3.22994,1,0
nyala,1,1,3.22994,3.22994,0,1
sisi,1,1,3.22994,3.22994,0,1
utara,1,1,3.22994,3.22994,0,1
legit,1,2,2.92891,2.92891,2,0
banget,1,2,2.92891,2.92891,2,0
limut,1,1,3.22994,3.22994,0,1
bau,1,3,2.75282,2.75282,0,3
sengat,1,1,3.22994,3.22994,0,1
gelontor,1,5,2.53097,2.53097,4,1
ecer,1,2,2.92891,2.92891,1,1
stok,1,9,2.27570,2.2757,8,1
libur,1,6,2.45179,2.45179,5,1
efek,1,3,2.75282,2.75282,2,1
hewan,1,14,2.08381,2.08381,11,3
ular,1,1,3.22994,3.22994,1,0
rabies,1,2,2.92891,2.92891,2,0
suntik,1,1,3.22994,3.22994,1,0
vaksin,1,3,2.75282,2.75282,3,0
spesialis,1,1,3.22994,3.22994,1,0
urologi,1,1,3.22994,3.22994,1,0
bakti,1,2,2.92891,2.92891,2,0
sosial,1,9,2.27570,2.2757,4,5
aksi,1,21,1.90772,1.90772,8,13
bersih,2,13,2.11599,4.23198,12,1
aktivitas,1,1,3.22994,3.22994,0,1
upaya,1,4,2.62788,2.62788,2,2
kiai,1,2,2.92891,2.92891,1,1
gadungan,1,2,2.92891,2.92891,0,2
perkosa,1,5,2.53097,2.53097,0,5
pop,1,2,2.92891,2.92891,0,2
galang,1,1,3.22994,3.22994,1,0
peduli,1,6,2.45179,2.45179,6,0
gempa,1,4,2.62788,2.62788,4,0
pertama,1,6,2.45179,2.45179,6,0
ilmu,1,2,2.92891,2.92891,2,0
arsitektur,1,1,3.22994,3.22994,1,0
layang,2,2,2.92891,5.85782,2,0
raup,1,6,2.45179,2.45179,6,0
untung,1,4,2.62788,2.62788,4,0
lurah,1,7,2.38484,2.38484,6,1
hapus,1,2,2.92891,2.92891,0,2
rias,1,3,2.75282,2.75282,1,2
wajah,1,4,2.62788,2.62788,1,3
alih,1,4,2.62788,2.62788,1,3
medium,1,2,2.92891,2.92891,0,2
tirta,1,1,3.22994,3.22994,1,0
bijak,1,2,2.92891,2.92891,1,1
murid,1,3,2.75282,2.75282,3,0
harap,1,13,2.11599,2.11599,9,4
baik,1,18,1.97467,1.97467,14,4
curi,1,23,1.86821,1.86821,0,23
kotak,1,3,2.75282,2.75282,0,3
amal,1,3,2.75282,2.75282,0,3
masjid,1,9,2.27570,2.2757,4,5
joli,1,2,2.92891,2.92891,0,2
amuk,1,2,2.92891,2.92891,0,2
enak,1,4,2.62788,2.62788,2,2
resep,1,1,3.22994,3.22994,1,0
puluh,1,7,2.38484,2.38484,3,4
bukti,1,4,2.62788,2.62788,0,4
bu,1,2,2.92891,2.92891,2,0
kuliner,1,5,2.53097,2.53097,5,0
legendaris,1,3,2.75282,2.75282,3,0
tidak,1,9,2.27570,2.2757,4,5
putus,1,4,2.62788,2.62788,1,3
generasi,1,2,2.92891,2.92891,1,1
ancam,1,15,2.05385,2.05385,1,14
bangsa,1,1,3.22994,3.22994,0,1
layak,1,9,2.27570,2.2757,8,1
taraf,1,2,2.92891,2.92891,2,0
aniaya,1,13,2.11599,2.11599,0,13
depresi,1,1,3.22994,3.22994,0,1
nekat,1,8,2.32685,2.32685,0,8
razia,1,2,2.92891,2.92891,1,1
siswi,1,1,3.22994,3.22994,0,1
pasrah,1,1,3.22994,3.22994,0,1
rugi,1,6,2.45179,2.45179,0,6
rokok,1,2,2.92891,2.92891,0,2
musnah,1,4,2.62788,2.62788,0,4
balas,1,4,2.62788,2.62788,0,4
awas,1,9,2.27570,2.2757,2,7
persen,1,10,2.22994,2.22994,9,1
lembar,1,1,3.22994,3.22994,1,0
program,1,5,2.53097,2.53097,5,0
distribusi,1,3,2.75282,2.75282,1,2
cipta,1,14,2.08381,2.08381,10,4
becak,1,1,3.22994,3.22994,1,0
listrik,1,5,2.53097,2.53097,3,2
ramah,1,2,2.92891,2.92891,2,0
lingkung,1,3,2.75282,2.75282,3,0
ku,1,1,3.22994,3.22994,1,0
apresiasi,1,8,2.32685,2.32685,7,1
bincang,1,1,3.22994,3.22994,1,0
kurir,1,1,3.22994,3.22994,0,1
akhir,1,11,2.18855,2.18855,2,9
omzet,1,4,2.62788,2.62788,3,1
pajak,1,5,2.53097,2.53097,4,1
tampil,1,6,2.45179,2.45179,6,0
desain,1,2,2.92891,2.92891,2,0
digital,1,7,2.38484,2.38484,7,0
pianis,1,1,3.22994,3.22994,1,0
piano,1,1,3.22994,3.22994,1,0
klasik,1,1,3.22994,3.22994,1,0
kostum,1,3,2.75282,2.75282,3,0
karnaval,1,1,3.22994,3.22994,1,0
pulih,1,1,3.22994,3.22994,0,1
bangun,1,16,2.02582,2.02582,11,5
rekam,1,13,2.11599,2.11599,1,12
batas,1,9,2.27570,2.2757,3,6
minimal,1,1,3.22994,3.22994,0,1
tunggu,1,4,2.62788,2.62788,1,3
raih,1,16,2.02582,2.02582,16,0
hut,1,15,2.05385,2.05385,13,2
kontes,1,1,3.22994,3.22994,1,0
lidi,1,1,3.22994,3.22994,1,0
indah,1,13,2.11599,2.11599,6,7
kuat,1,8,2.32685,2.32685,8,0
energi,1,1,3.22994,3.22994,1,0
tekan,1,10,2.22994,2.22994,7,3
polusi,1,1,3.22994,3.22994,1,0
daftar,2,16,2.02582,4.05164,15,1
stasiun,1,7,2.38484,2.38484,3,4
cetak,1,2,2.92891,2.92891,1,1
jiwa,1,7,2.38484,2.38484,2,5
kampus,1,9,2.27570,2.2757,6,3
nikmat,1,10,2.22994,2.22994,10,0
sensasi,1,2,2.92891,2.92891,2,0
pikir,1,1,3.22994,3.22994,1,0
pondok,1,2,2.92891,2.92891,1,1
sawah,1,3,2.75282,2.75282,3,0
gersang,1,1,3.22994,3.22994,1,0
tani,1,8,2.32685,2.32685,8,0
semangka,1,1,3.22994,3.22994,1,0
jagung,1,2,2.92891,2.92891,2,0
latih,1,9,2.27570,2.2757,8,1
asi,1,1,3.22994,3.22994,1,0
copot,1,4,2.62788,2.62788,0,4
buntut,1,2,2.92891,2.92891,0,2
spesial,1,1,3.22994,3.22994,1,0
baca,1,1,3.22994,3.22994,1,0
berita,1,1,3.22994,3.22994,1,0
kakek,1,1,3.22994,3.22994,1,0
seniman,1,2,2.92891,2.92891,2,0
patung,1,1,3.22994,3.22994,1,0
gulai,1,1,3.22994,3.22994,1,0
kapasitas,1,1,3.22994,3.22994,0,1
liter,1,7,2.38484,2.38484,3,4
angka,1,6,2.45179,2.45179,5,1
satelit,1,1,3.22994,3.22994,1,0
kamera,1,1,3.22994,3.22994,0,1
leceh,1,2,2.92891,2.92891,0,2
izin,1,6,2.45179,2.45179,1,5
pengaruh,1,2,2.92891,2.92891,0,2
non,1,1,3.22994,3.22994,0,1
subsidi,1,2,2.92891,2.92891,0,2
fakultas,1,3,2.75282,2.75282,1,2
tinggal,1,22,1.88752,1.88752,3,19
kontra,1,1,3.22994,3.22994,0,1
selidik,1,6,2.45179,2.45179,0,6
baco,1,3,2.75282,2.75282,0,3
donasi,1,1,3.22994,3.22994,1,0
ajar,1,13,2.11599,2.11599,12,1
sidang,1,3,2.75282,2.75282,1,2
agustus,1,4,2.62788,2.62788,2,2
denda,1,2,2.92891,2.92891,0,2
pamit,1,5,2.53097,2.53097,1,4
racik,1,1,3.22994,3.22994,0,1
kosmetik,1,1,3.22994,3.22994,0,1
momen,1,12,2.15076,2.15076,8,4
haru,1,3,2.75282,2.75282,0,3
istri,1,8,2.32685,2.32685,2,6
leleh,1,1,3.22994,3.22994,0,1
gadis,1,1,3.22994,3.22994,0,1
belia,1,1,3.22994,3.22994,0,1
tegal,1,5,2.53097,2.53097,2,3
kulit,1,2,2.92891,2.92891,1,1
langka,1,4,2.62788,2.62788,0,4
butuh,1,6,2.45179,2.45179,3,3
humas,2,4,2.62788,5.25576,4,0
bekal,1,4,2.62788,2.62788,4,0
reputasi,1,1,3.22994,3.22994,1,0
percaya,1,3,2.75282,2.75282,1,2
lelah,1,4,2.62788,2.62788,2,2
jijik,1,1,3.22994,3.22994,1,0
debat,1,3,2.75282,2.75282,1,2
politik,1,8,2.32685,2.32685,8,0
gaung,1,1,3.22994,3.22994,1,0
damai,1,9,2.27570,2.2757,7,2
progresif,1,2,2.92891,2.92891,2,0
sudut,1,2,2.92891,2.92891,2,0
ganggu,1,6,2.45179,2.45179,0,6
anggur,1,1,3.22994,3.22994,1,0
didik,1,7,2.38484,2.38484,7,0
ikan,1,4,2.62788,2.62788,4,0
merdeka,1,7,2.38484,2.38484,7,0
hadir,1,21,1.90772,1.90772,19,2
acara,1,4,2.62788,2.62788,3,1
hindar,1,3,2.75282,2.75282,3,0
sih,1,4,2.62788,2.62788,2,2
lepas,1,6,2.45179,2.45179,5,1
republik,1,1,3.22994,3.22994,0,1
batik,2,2,2.92891,5.85782,2,0
beasiswa,1,1,3.22994,3.22994,1,0
wajib,1,4,2.62788,2.62788,2,2
cemburu,1,2,2.92891,2.92891,0,2
tega,1,2,2.92891,2.92891,0,2
tusuk,1,3,2.75282,2.75282,1,2
suami,1,6,2.45179,2.45179,2,4
palu,1,1,3.22994,3.22994,1,0
kapal,1,18,1.97467,1.97467,16,2
ganti,1,5,2.53097,2.53097,1,4
puji,1,8,2.32685,2.32685,7,1
inisiasi,1,1,3.22994,3.22994,1,0
alas,1,13,2.11599,2.11599,2,11
rintis,1,3,2.75282,2.75282,3,0
keren,1,3,2.75282,2.75282,3,0
rawat,1,1,3.22994,3.22994,1,0
keris,1,2,2.92891,2.92891,2,0
kampanye,1,7,2.38484,2.38484,4,3
larang,1,11,2.18855,2.18855,2,9
cari,1,3,2.75282,2.75282,1,2
bibit,1,4,2.62788,2.62788,4,0
basket,1,1,3.22994,3.22994,1,0
laga,1,10,2.22994,2.22994,4,6
tengkar,1,1,3.22994,3.22994,0,1
bunga,1,2,2.92891,2.92891,2,0
cantik,1,6,2.45179,2.45179,6,0
perempuan,1,12,2.15076,2.15076,5,7
bek,1,1,3.22994,3.22994,1,0
wahyu,1,1,3.22994,3.22994,1,0
cekcok,1,3,2.75282,2.75282,1,2
dongkrak,1,1,3.22994,3.22994,1,0
parade,1,5,2.53097,2.53097,5,0
hias,1,5,2.53097,2.53097,5,0
tabur,1,2,2.92891,2.92891,1,1
bawa,1,6,2.45179,2.45179,2,4
arus,1,18,1.97467,1.97467,15,3
pidato,1,2,2.92891,2.92891,0,2
seruduk,1,2,2.92891,2.92891,0,2
hambat,1,2,2.92891,2.92891,0,2
maju,1,5,2.53097,2.53097,3,2
konsolidasi,1,2,2.92891,2.92891,0,2
belah,1,3,2.75282,2.75282,2,1
budiman,1,2,2.92891,2.92891,2,0
sudah,1,14,2.08381,2.08381,7,7
selesai,1,1,3.22994,3.22994,1,0
urus,1,3,2.75282,2.75282,3,0
tuan,1,4,2.62788,2.62788,2,2
puncak,1,5,2.53097,2.53097,5,0
ramai,1,5,2.53097,2.53097,5,0
rukun,1,6,2.45179,2.45179,6,0
camat,1,4,2.62788,2.62788,2,2
strategi,1,4,2.62788,2.62788,4,0
kandang,1,4,2.62788,2.62788,3,1
banteng,1,3,2.75282,2.75282,2,1
dorong,1,9,2.27570,2.2757,9,0
optimal,1,2,2.92891,2.92891,1,1
persik,1,1,3.22994,3.22994,1,0
absen,1,2,2.92891,2.92891,1,1
paguyuban,1,1,3.22994,3.22994,1,0
hukum,1,4,2.62788,2.62788,3,1
kumpul,1,5,2.53097,2.53097,3,2
koin,1,4,2.62788,2.62788,3,1
miskin,1,6,2.45179,2.45179,1,5
krisis,1,2,2.92891,2.92891,1,1
estafet,1,1,3.22994,3.22994,1,0
mata,1,6,2.45179,2.45179,1,5
basmi,1,1,3.22994,3.22994,1,0
hama,1,1,3.22994,3.22994,1,0
tikus,1,3,2.75282,2.75282,2,1
meja,1,2,2.92891,2.92891,2,0
optimis,1,4,2.62788,2.62788,4,0
investasi,1,4,2.62788,2.62788,4,0
saing,1,1,3.22994,3.22994,1,0
rakit,1,1,3.22994,3.22994,0,1
senjata,1,3,2.75282,2.75282,1,2
jamu,1,2,2.92891,2.92891,2,0
makam,1,9,2.27570,2.2757,4,5
rusuh,1,2,2.92891,2.92891,0,2
caci,1,1,3.22994,3.22994,1,0
bala,1,1,3.22994,3.22994,0,1
delegasi,1,1,3.22994,3.22994,1,0
inovasi,1,8,2.32685,2.32685,8,0
lempar,1,2,2.92891,2.92891,1,1
bandung,1,38,1.65015,1.65015,35,3
gotong,1,2,2.92891,2.92891,1,1
cegah,1,33,1.71142,1.71142,28,5
tindak,1,5,2.53097,2.53097,4,1
jahat,1,3,2.75282,2.75282,2,1
luncur,1,6,2.45179,2.45179,5,1
aplikasi,1,7,2.38484,2.38484,6,1
tukang,1,1,3.22994,3.22994,0,1
servis,1,1,3.22994,3.22994,0,1
modifikasi,1,3,2.75282,2.75282,2,1
teroris,1,1,3.22994,3.22994,0,1
de,1,1,3.22994,3.22994,0,1
lawan,1,6,2.45179,2.45179,4,2
evaluasi,1,2,2.92891,2.92891,1,1
baju,1,3,2.75282,2.75282,3,0
adat,1,1,3.22994,3.22994,1,0
maaf,1,7,2.38484,2.38484,0,7
pahlawan,1,1,3.22994,3.22994,0,1
upacara,1,4,2.62788,2.62788,2,2
remisi,1,1,3.22994,3.22994,1,0
titip,1,1,3.22994,3.22994,1,0
narapidana,1,1,3.22994,3.22994,1,0
lansia,1,4,2.62788,2.62788,2,2
khas,1,6,2.45179,2.45179,6,0
kompak,1,3,2.75282,2.75282,3,0
pukau,1,2,2.92891,2.92891,2,0
nyanyi,1,1,3.22994,3.22994,1,0
simfoni,1,1,3.22994,3.22994,1,0
istana,1,3,2.75282,2.75282,2,1
karaoke,1,2,2.92891,2.92891,1,1
hajar,1,1,3.22994,3.22994,0,1
massa,1,1,3.22994,3.22994,0,1
sambut,1,11,2.18855,2.18855,11,0
ekonomi,1,3,2.75282,2.75282,2,1
junjung,1,1,3.22994,3.22994,1,0
vakum,1,1,3.22994,3.22994,1,0
voli,1,2,2.92891,2.92891,2,0
merah,1,6,2.45179,2.45179,1,5
kawasan,1,5,2.53097,2.53097,4,1
sejarah,1,1,3.22994,3.22994,1,0
perwira,1,2,2.92891,2.92891,2,0
waris,1,1,3.22994,3.22994,1,0
bangga,1,2,2.92891,2.92891,2,0
telak,1,1,3.22994,3.22994,1,0
ajang,1,3,2.75282,2.75282,3,0
medali,1,3,2.75282,2.75282,2,1
lobster,1,1,3.22994,3.22994,1,0
rawa,2,1,3.22994,6.45988,1,0
pening,1,1,3.22994,3.22994,1,0
mode,1,1,3.22994,3.22994,1,0
pagelaran,1,2,2.92891,2.92891,2,0
busana,1,2,2.92891,2.92891,2,0
si,1,1,3.22994,3.22994,1,0
anggrek,1,1,3.22994,3.22994,1,0
buru,1,9,2.27570,2.2757,7,2
minat,1,2,2.92891,2.92891,2,0
angkut,1,6,2.45179,2.45179,6,0
tanding,1,3,2.75282,2.75282,1,2
ekshibisi,1,1,3.22994,3.22994,1,0
juara,1,5,2.53097,2.53097,5,0
olahraga,1,5,2.53097,2.53097,4,1
provinsi,1,2,2.92891,2.92891,2,0
hulu,1,2,2.92891,2.92891,2,0
ruang,1,2,2.92891,2.92891,1,1
hotel,1,7,2.38484,2.38484,5,2
hutan,1,1,3.22994,3.22994,1,0
penuh,1,3,2.75282,2.75282,3,0
tertib,1,1,3.22994,3.22994,1,0
kunjung,1,5,2.53097,2.53097,3,2
silaturahmi,1,2,2.92891,2.92891,2,0
paspor,1,4,2.62788,2.62788,4,0
serbu,1,3,2.75282,2.75282,3,0
kreativitas,1,5,2.53097,2.53097,5,0
mural,1,1,3.22994,3.22994,1,0
kantong,1,1,3.22994,3.22994,0,1
nol,1,1,3.22994,3.22994,1,0
integrasi,1,3,2.75282,2.75282,3,0
sigap,1,2,2.92891,2.92891,2,0
pelita,1,3,2.75282,2.75282,3,0
kerja,1,9,2.27570,2.2757,1,8
hebat,1,8,2.32685,2.32685,7,1
urut,1,2,2.92891,2.92891,1,1
lingkar,1,1,3.22994,3.22994,0,1
kendal,1,4,2.62788,2.62788,1,3
wayang,1,2,2.92891,2.92891,2,0
film,1,3,2.75282,2.75282,3,0
olak,1,3,2.75282,2.75282,0,3
lupa,1,1,3.22994,3.22994,0,1
maulana,1,1,3.22994,3.22994,0,1
laskar,1,1,3.22994,3.22994,0,1
petik,1,2,2.92891,2.92891,1,1
umat,1,4,2.62788,2.62788,4,0
sempurna,1,1,3.22994,3.22994,1,0
dewi,1,2,2.92891,2.92891,2,0
welas,1,2,2.92891,2.92891,2,0
asih,1,2,2.92891,2.92891,2,0
rebut,1,4,2.62788,2.62788,2,2
honorer,1,2,2.92891,2.92891,0,2
rusa,1,2,2.92891,2.92891,1,1
pancasila,1,6,2.45179,2.45179,5,1
soto,1,2,2.92891,2.92891,2,0
organik,1,2,2.92891,2.92891,2,0
ubah,1,1,3.22994,3.22994,1,0
hobi,1,1,3.22994,3.22994,1,0
taekwondo,1,1,3.22994,3.22994,1,0
daya,1,3,2.75282,2.75282,2,1
tangga,1,1,3.22994,3.22994,1,0
tata,1,3,2.75282,2.75282,3,0
golput,1,1,3.22994,3.22994,0,1
erata,1,1,3.22994,3.22994,1,0
saraf,1,1,3.22994,3.22994,1,0
selebaran,1,1,3.22994,3.22994,1,0
imbau,1,7,2.38484,2.38484,3,4
hati,2,7,2.38484,4.76968,1,6
inovatif,1,1,3.22994,3.22994,1,0
punakawan,1,1,3.22994,3.22994,1,0
pedoman,1,1,3.22994,3.22994,1,0
naskah,1,1,3.22994,3.22994,1,0
adil,1,2,2.92891,2.92891,1,1
gol,1,2,2.92891,2.92891,0,2
tunggal,1,1,3.22994,3.22994,0,1
tunduk,1,1,3.22994,3.22994,0,1
kudeta,1,1,3.22994,3.22994,0,1
tren,1,3,2.75282,2.75282,3,0
positif,1,1,3.22994,3.22994,1,0
cepat,1,16,2.02582,2.02582,9,7
puas,1,2,2.92891,2.92891,1,1
wisata,1,8,2.32685,2.32685,8,0
lumpia,1,1,3.22994,3.22994,1,0
angsur,1,2,2.92891,2.92891,0,2
rotasi,1,2,2.92891,2.92891,2,0
kompetensi,1,3,2.75282,2.75282,3,0
sasar,1,2,2.92891,2.92891,1,1
baliho,1,1,3.22994,3.22994,1,0
spanduk,1,1,3.22994,3.22994,1,0
bendera,1,2,2.92891,2.92891,2,0
jamur,1,1,3.22994,3.22994,1,0
sewu,1,1,3.22994,3.22994,0,1
mutasi,1,1,3.22994,3.22994,0,1
rampas,1,2,2.92891,2.92891,0,2
tugas,1,11,2.18855,2.18855,5,6
jurnal,1,1,3.22994,3.22994,1,0
pasok,1,2,2.92891,2.92891,2,0
pangkal,1,1,3.22994,3.22994,1,0
lancar,1,2,2.92891,2.92891,2,0
klaim,1,2,2.92891,2.92891,2,0
bawang,1,8,2.32685,2.32685,0,8
konsumen,1,2,2.92891,2.92891,1,1
hektar,1,1,3.22994,3.22994,1,0
lahan,1,7,2.38484,2.38484,3,4
banjir,2,22,1.88752,3.77504,9,13
kanal,1,3,2.75282,2.75282,2,1
barat,1,2,2.92891,2.92891,2,0
gagal,1,2,2.92891,2.92891,0,2
retas,1,1,3.22994,3.22994,0,1
antisipasi,1,12,2.15076,2.15076,10,2
anarkis,1,1,3.22994,3.22994,1,0
diskusi,1,1,3.22994,3.22994,1,0
mediasi,1,1,3.22994,3.22994,1,0
elektronik,1,1,3.22994,3.22994,1,0
akademisi,1,1,3.22994,3.22994,1,0
universitas,1,3,2.75282,2.75282,3,0
lebam,1,1,3.22994,3.22994,0,1
darah,1,5,2.53097,2.53097,2,3
plastik,1,4,2.62788,2.62788,2,2
daur,1,2,2.92891,2.92891,2,0
asyura,1,1,3.22994,3.22994,1,0
momentum,1,2,2.92891,2.92891,2,0
yatim,1,3,2.75282,2.75282,3,0
irit,1,1,3.22994,3.22994,1,0
pupuk,1,1,3.22994,3.22994,1,0
kimia,1,1,3.22994,3.22994,1,0
mudah,1,5,2.53097,2.53097,4,1
rupiah,1,4,2.62788,2.62788,3,1
busuk,1,2,2.92891,2.92891,0,2
luk,1,3,2.75282,2.75282,3,0
batu,1,3,2.75282,2.75282,2,1
sungai,1,7,2.38484,2.38484,3,4
seksual,1,3,2.75282,2.75282,0,3
jatuh,1,1,3.22994,3.22994,0,1
bunuh,1,48,1.54870,1.5487,0,48
taksi,1,11,2.18855,2.18855,0,11
hamil,1,3,2.75282,2.75282,2,1
juli,1,4,2.62788,2.62788,2,2
uji,1,5,2.53097,2.53097,4,1
massal,1,3,2.75282,2.75282,2,1
cinta,1,6,2.45179,2.45179,5,1
doa,1,2,2.92891,2.92891,1,1
nama,1,4,2.62788,2.62788,1,3
sertifikat,1,6,2.45179,2.45179,1,5
rentenir,1,2,2.92891,2.92891,0,2
kaget,1,2,2.92891,2.92891,0,2
jamin,1,5,2.53097,2.53097,3,2
barang,1,1,3.22994,3.22994,0,1
pilar,1,1,3.22994,3.22994,0,1
resah,1,2,2.92891,2.92891,0,2
dadak,1,4,2.62788,2.62788,0,4
agun,1,2,2.92891,2.92891,0,2
taat,1,1,3.22994,3.22994,0,1
atur,1,6,2.45179,2.45179,4,2
kecewa,1,3,2.75282,2.75282,0,3
coret,1,1,3.22994,3.22994,0,1
nasional,1,8,2.32685,2.32685,7,1
rekonstruksi,1,19,1.95118,1.95118,1,18
potong,1,6,2.45179,2.45179,0,6
sindir,1,1,3.22994,3.22994,0,1
status,1,1,3.22994,3.22994,0,1
penjara,1,5,2.53097,2.53097,0,5
bisnis,1,4,2.62788,2.62788,4,0
adaptasi,1,1,3.22994,3.22994,1,0
era,1,2,2.92891,2.92891,2,0
disrupsi,1,1,3.22994,3.22994,1,0
lantik,1,15,2.05385,2.05385,15,0
integritas,1,1,3.22994,3.22994,1,0
pakan,1,1,3.22994,3.22994,0,1
kejat,1,1,3.22994,3.22994,1,0
rambu,1,2,2.92891,2.92891,0,2
pasang,1,4,2.62788,2.62788,3,1
kisah,1,5,2.53097,2.53097,4,1
budi,1,3,2.75282,2.75282,3,0
beber,1,1,3.22994,3.22994,0,1
adik,1,1,3.22994,3.22994,0,1
ayah,1,2,2.92891,2.92891,1,1
jalur,1,16,2.02582,2.02582,7,9
mandiri,1,3,2.75282,2.75282,3,0
reguler,1,1,3.22994,3.22994,1,0
tahap,1,5,2.53097,2.53097,5,0
besok,1,1,3.22994,3.22994,1,0
simak,1,3,2.75282,2.75282,3,0
desa,1,3,2.75282,2.75282,2,1
perabot,1,2,2.92891,2.92891,0,2
keliling,1,2,2.92891,2.92891,1,1
koper,2,1,3.22994,6.45988,0,1
utama,1,9,2.27570,2.2757,6,3
forum,1,2,2.92891,2.92891,2,0
geger,1,2,2.92891,2.92891,0,2
ampo,1,9,2.27570,2.2757,0,9
heroik,1,6,2.45179,2.45179,5,1
asisten,1,2,2.92891,2.92891,1,1
risiko,1,1,3.22994,3.22994,0,1
bidang,1,2,2.92891,2.92891,1,1
langsung,1,4,2.62788,2.62788,2,2
amin,1,2,2.92891,2.92891,2,0
kriminal,1,2,2.92891,2.92891,1,1
kabur,1,6,2.45179,2.45179,0,6
sungkur,1,1,3.22994,3.22994,0,1
komentar,1,1,3.22994,3.22994,0,1
sorot,1,4,2.62788,2.62788,2,2
haris,1,1,3.22994,3.22994,0,1
trailer,1,8,2.32685,2.32685,0,8
dengar,1,2,2.92891,2.92891,2,0
hak,1,2,2.92891,2.92891,2,0
hidup,1,5,2.53097,2.53097,2,3
kenang,1,6,2.45179,2.45179,6,0
antik,1,2,2.92891,2.92891,2,0
lokasi,1,6,2.45179,2.45179,1,5
aju,1,2,2.92891,2.92891,1,1
tuntut,1,11,2.18855,2.18855,0,11
umpuk,1,1,3.22994,3.22994,0,1
mogok,1,5,2.53097,2.53097,0,5
rel,1,7,2.38484,2.38484,1,6
medan,1,14,2.08381,2.08381,13,1
magnet,1,1,3.22994,3.22994,0,1
jadwal,1,39,1.63887,1.63887,39,0
ekspres,1,2,2.92891,2.92891,2,0
rute,1,1,3.22994,3.22994,1,0
bentuk,1,5,2.53097,2.53097,2,3
investigasi,1,3,2.75282,2.75282,0,3
tumpang,1,18,1.97467,1.97467,9,9
koperasi,2,2,2.92891,5.85782,2,0
kembang,1,7,2.38484,2.38484,6,1
ajaib,1,1,3.22994,3.22994,1,0
tuhan,1,1,3.22994,3.22994,1,0
human,1,1,3.22994,3.22994,0,1
panik,1,2,2.92891,2.92891,0,2
pacu,1,1,3.22994,3.22994,1,0
biologi,1,1,3.22994,3.22994,1,0
palang,1,2,2.92891,2.92891,0,2
pintu,1,3,2.75282,2.75282,1,2
jembatan,1,6,2.45179,2.45179,5,1
bobol,1,3,2.75282,2.75282,0,3
sidik,1,3,2.75282,2.75282,2,1
salah,1,9,2.27570,2.2757,0,9
transportasi,1,1,3.22994,3.22994,0,1
tuai,1,3,2.75282,2.75282,3,0
ekspedisi,1,1,3.22994,3.22994,0,1
imbas,1,3,2.75282,2.75282,0,3
rancang,1,2,2.92891,2.92891,1,1
bodi,1,1,3.22994,3.22994,1,0
rendah,1,3,2.75282,2.75282,2,1
usut,1,2,2.92891,2.92891,0,2
abrak,1,1,3.22994,3.22994,0,1
ekspresi,1,1,3.22994,3.22994,1,0
tradisi,1,8,2.32685,2.32685,8,0
unik,1,6,2.45179,2.45179,6,0
cuci,1,2,2.92891,2.92891,1,1
kuda,1,3,2.75282,2.75282,1,2
lumping,1,1,3.22994,3.22994,1,0
gunung,1,29,1.76754,1.76754,0,29
es,1,2,2.92891,2.92891,0,2
tolong,1,6,2.45179,2.45179,1,5
jenis,1,2,2.92891,2.92891,0,2
khawatir,1,1,3.22994,3.22994,1,0
insiden,1,1,3.22994,3.22994,0,1
tebang,1,1,3.22994,3.22994,0,1
hijau,1,4,2.62788,2.62788,2,2
waduk,1,1,3.22994,3.22994,0,1
uju,1,3,2.75282,2.75282,3,0
lambat,1,4,2.62788,2.62788,0,4
takut,1,3,2.75282,2.75282,0,3
kaca,1,1,3.22994,3.22994,0,1
sinau,1,3,2.75282,2.75282,0,3
miris,1,1,3.22994,3.22994,0,1
bayi,1,5,2.53097,2.53097,0,5
sangkut,1,1,3.22994,3.22994,0,1
jerit,1,1,3.22994,3.22994,0,1
andal,1,1,3.22994,3.22994,0,1
cedera,1,2,2.92891,2.92891,0,2
lokomotif,1,2,2.92891,2.92891,1,1
telat,1,1,3.22994,3.22994,0,1
kompensasi,1,1,3.22994,3.22994,0,1
pidana,1,2,2.92891,2.92891,1,1
langgar,1,4,2.62788,2.62788,1,3
bentur,1,1,3.22994,3.22994,0,1
asa,1,1,3.22994,3.22994,0,1
pantau,1,8,2.32685,2.32685,6,2
evakuasi,1,7,2.38484,2.38484,1,6
fungsi,1,2,2.92891,2.92891,2,0
mati,1,13,2.11599,2.11599,0,13
kepala,1,6,2.45179,2.45179,3,3
badan,1,1,3.22994,3.22994,0,1
ringsek,1,1,3.22994,3.22994,0,1
pindah,1,3,2.75282,2.75282,0,3
deret,1,2,2.92891,2.92891,0,2
kobar,1,2,2.92891,2.92891,0,2
gerbong,1,1,3.22994,3.22994,0,1
ngeri,1,1,3.22994,3.22994,0,1
bumbung,1,1,3.22994,3.22994,0,1
tuntas,1,1,3.22994,3.22994,0,1
swasta,1,3,2.75282,2.75282,1,2
ambah,1,3,2.75282,2.75282,2,1
serap,1,3,2.75282,2.75282,3,0
aspirasi,1,2,2.92891,2.92891,2,0
jelajah,1,1,3.22994,3.22994,1,0
sapa,1,2,2.92891,2.92891,2,0
giur,1,1,3.22994,3.22994,1,0
berkas,1,1,3.22994,3.22994,1,0
kontraktor,1,1,3.22994,3.22994,1,0
baja,1,1,3.22994,3.22994,1,0
mukim,1,4,2.62788,2.62788,1,3
panitia,1,1,3.22994,3.22994,0,1
aroma,1,2,2.92891,2.92891,1,1
khusus,1,4,2.62788,2.62788,3,1
lirik,1,1,3.22994,3.22994,1,0
barkas,1,1,3.22994,3.22994,1,0
tabung,1,5,2.53097,2.53097,4,1
buat,1,18,1.97467,1.97467,11,7
rahayu,1,5,2.53097,2.53097,5,0
surati,1,1,3.22994,3.22994,1,0
bahas,1,3,2.75282,2.75282,2,1
sinergi,1,1,3.22994,3.22994,1,0
eksportir,1,1,3.22994,3.22994,1,0
dokumen,1,1,3.22994,3.22994,1,0
pol,1,1,3.22994,3.22994,1,0
taman,1,5,2.53097,2.53097,4,1
pinggang,1,1,3.22994,3.22994,0,1
tonton,1,3,2.75282,2.75282,1,2
wanita,1,4,2.62788,2.62788,2,2
boks,1,2,2.92891,2.92891,0,2
susu,1,2,2.92891,2.92891,0,2
formula,1,2,2.92891,2.92891,0,2
minimarket,1,2,2.92891,2.92891,0,2
potensi,1,4,2.62788,2.62788,2,2
pesisir,1,3,2.75282,2.75282,2,1
sportif,1,1,3.22994,3.22994,1,0
bocah,1,2,2.92891,2.92891,0,2
trauma,1,1,3.22994,3.22994,0,1
dunia,1,6,2.45179,2.45179,2,4
haji,1,8,2.32685,2.32685,7,1
konsumsi,1,5,2.53097,2.53097,5,0
antraks,1,3,2.75282,2.75282,2,1
coba,1,6,2.45179,2.45179,1,5
patuh,1,2,2.92891,2.92891,1,1
balai,1,3,2.75282,2.75282,1,2
karantina,1,1,3.22994,3.22994,1,0
virus,1,1,3.22994,3.22994,1,0
keroyok,1,1,3.22994,3.22994,0,1
rampok,1,1,3.22994,3.22994,0,1
cocok,1,1,3.22994,3.22994,1,0
data,1,2,2.92891,2.92891,1,1
lipat,1,1,3.22994,3.22994,1,0
miniatur,1,3,2.75282,2.75282,3,0
uap,1,2,2.92891,2.92891,1,1
gengsi,1,1,3.22994,3.22994,1,0
benih,1,1,3.22994,3.22994,1,0
padi,1,1,3.22994,3.22994,1,0
duel,1,2,2.92891,2.92891,0,2
sita,1,3,2.75282,2.75282,0,3
tarik,1,2,2.92891,2.92891,1,1
geografi,1,1,3.22994,3.22994,1,0
idola,1,1,3.22994,3.22994,1,0
kamil,1,1,3.22994,3.22994,1,0
contoh,1,3,2.75282,2.75282,3,0
suplai,1,2,2.92891,2.92891,2,0
kelola,1,3,2.75282,2.75282,3,0
lokalisasi,1,1,3.22994,3.22994,0,1
protes,1,2,2.92891,2.92891,0,2
bekas,1,3,2.75282,2.75282,1,2
gali,1,3,2.75282,2.75282,1,2
zonasi,1,2,2.92891,2.92891,1,1
alir,1,2,2.92891,2.92891,0,2
tubuh,1,1,3.22994,3.22994,0,1
ambles,1,4,2.62788,2.62788,1,3
langkah,1,3,2.75282,2.75282,3,0
durasi,1,1,3.22994,3.22994,1,0
rambah,1,1,3.22994,3.22994,0,1
dasar,1,1,3.22994,3.22994,0,1
maling,1,2,2.92891,2.92891,0,2
aspek,1,1,3.22994,3.22994,0,1
guling,1,5,2.53097,2.53097,2,3
muat,1,3,2.75282,2.75282,0,3
tumpah,1,1,3.22994,3.22994,0,1
lebat,1,1,3.22994,3.22994,1,0
guyur,1,2,2.92891,2.92891,1,1
sebar,1,3,2.75282,2.75282,2,1
video,1,2,2.92891,2.92891,0,2
syur,1,1,3.22994,3.22994,0,1
mantan,1,2,2.92891,2.92891,0,2
kasih,1,2,2.92891,2.92891,1,1
cabai,1,8,2.32685,2.32685,0,8
sayur,1,3,2.75282,2.75282,0,3
erong,1,5,2.53097,2.53097,1,4
toleransi,1,6,2.45179,2.45179,6,0
praktik,1,2,2.92891,2.92891,1,1
teori,1,1,3.22994,3.22994,1,0
gede,1,2,2.92891,2.92891,2,0
rental,1,1,3.22994,3.22994,0,1
wortel,1,1,3.22994,3.22994,0,1
atraksi,1,1,3.22994,3.22994,1,0
artis,1,2,2.92891,2.92891,2,0
populasi,1,1,3.22994,3.22994,0,1
jarah,1,1,3.22994,3.22994,0,1
proses,1,2,2.92891,2.92891,1,1
kaum,1,2,2.92891,2.92891,1,1
fakir,1,1,3.22994,3.22994,0,1
antre,1,4,2.62788,2.62788,2,2
kurban,1,15,2.05385,2.05385,12,3
agung,1,3,2.75282,2.75282,0,3
bhayangkara,1,1,3.22994,3.22994,0,1
presisi,1,1,3.22994,3.22994,0,1
media,1,7,2.38484,2.38484,2,5
terapi,1,2,2.92891,2.92891,2,0
piagam,1,1,3.22994,3.22994,0,1
prestasi,1,2,2.92891,2.92891,1,1
palsu,1,2,2.92891,2.92891,0,2
ketemu,1,1,3.22994,3.22994,0,1
bengkel,1,2,2.92891,2.92891,1,1
manis,1,4,2.62788,2.62788,4,0
graha,1,1,3.22994,3.22994,0,1
predikat,1,2,2.92891,2.92891,2,0
tiket,1,5,2.53097,2.53097,3,2
satai,1,1,3.22994,3.22994,1,0
arang,1,1,3.22994,3.22994,1,0
jasa,1,3,2.75282,2.75282,2,1
urun,1,1,3.22994,3.22994,0,1
sumbang,1,1,3.22994,3.22994,1,0
optimistis,1,1,3.22994,3.22994,1,0
mudik,1,23,1.86821,1.86821,21,2
volume,1,1,3.22994,3.22994,1,0
khatib,1,1,3.22994,3.22994,1,0
iduladha,1,1,3.22994,3.22994,1,0
saudara,1,1,3.22994,3.22994,1,0
edukatif,1,2,2.92891,2.92891,2,0
lahir,1,6,2.45179,2.45179,5,1
pesawat,1,3,2.75282,2.75282,1,2
terbang,1,3,2.75282,2.75282,1,2
warung,1,2,2.92891,2.92891,1,1
menu,1,4,2.62788,2.62788,4,0
kecombrang,1,1,3.22994,3.22994,1,0
selokan,1,3,2.75282,2.75282,0,3
garut,1,1,3.22994,3.22994,1,0
dar,1,1,3.22994,3.22994,0,1
antusiasme,1,2,2.92891,2.92891,2,0
gandeng,1,10,2.22994,2.22994,8,2
ketat,1,3,2.75282,2.75282,2,1
sejahtera,1,1,3.22994,3.22994,1,0
biaya,1,5,2.53097,2.53097,3,2
masyarakat,1,7,2.38484,2.38484,6,1
pisah,1,1,3.22994,3.22994,0,1
bahasa,1,3,2.75282,2.75282,2,1
bina,1,1,3.22994,3.22994,1,0
prioritas,1,2,2.92891,2.92891,2,0
kantin,1,1,3.22994,3.22994,1,0
kebaji,1,1,3.22994,3.22994,1,0
selasa,1,5,2.53097,2.53097,5,0
ulik,1,1,3.22994,3.22994,1,0
gugah,1,1,3.22994,3.22994,1,0
selera,1,1,3.22994,3.22994,1,0
verifikasi,1,1,3.22994,3.22994,0,1
kendala,1,1,3.22994,3.22994,0,1
endemi,1,1,3.22994,3.22994,1,0
arik,1,1,3.22994,3.22994,1,0
teladan,1,1,3.22994,3.22994,1,0
kualitas,1,2,2.92891,2.92891,2,0
profesor,1,1,3.22994,3.22994,1,0
logo,1,1,3.22994,3.22994,1,0
diskon,1,3,2.75282,2.75282,3,0
taktik,1,1,3.22994,3.22994,1,0
cermat,1,1,3.22994,3.22994,1,0
rupa,1,2,2.92891,2.92891,2,0
ahli,1,2,2.92891,2.92891,1,1
gizi,1,2,2.92891,2.92891,1,1
puskesmas,1,1,3.22994,3.22994,0,1
agam,1,1,3.22994,3.22994,1,0
tong,1,1,3.22994,3.22994,1,0
klenteng,1,1,3.22994,3.22994,1,0
napas,1,2,2.92891,2.92891,1,1
lega,1,1,3.22994,3.22994,1,0
cincin,1,2,2.92891,2.92891,2,0
malu,1,2,2.92891,2.92891,2,0
musik,1,5,2.53097,2.53097,5,0
bakat,1,1,3.22994,3.22994,1,0
calon,1,9,2.27570,2.2757,8,1
teknis,1,1,3.22994,3.22994,0,1
restu,1,2,2.92891,2.92891,2,0
impor,1,2,2.92891,2.92891,2,0
ngilu,1,1,3.22994,3.22994,1,0
vital,1,1,3.22994,3.22994,1,0
gencar,1,2,2.92891,2.92891,2,0
vaksinasi,1,7,2.38484,2.38484,7,0
kambing,1,7,2.38484,2.38484,7,0
hilal,1,2,2.92891,2.92891,0,2
zulhijah,1,1,3.22994,3.22994,0,1
limbah,1,2,2.92891,2.92891,2,0
receh,1,1,3.22994,3.22994,1,0
rekrut,1,1,3.22994,3.22994,0,1
tenaga,1,1,3.22994,3.22994,0,1
susup,1,2,2.92891,2.92891,0,2
halal,1,2,2.92891,2.92891,2,0
alam,1,2,2.92891,2.92891,2,0
kompetisi,1,2,2.92891,2.92891,2,0
logika,1,1,3.22994,3.22994,1,0
matematika,1,1,3.22994,3.22994,1,0
ember,1,1,3.22994,3.22994,1,0
jerat,1,1,3.22994,3.22994,0,1
pasal,1,1,3.22994,3.22994,0,1
ayat,1,1,3.22994,3.22994,0,1
kampung,1,2,2.92891,2.92891,2,0
terna,1,1,3.22994,3.22994,1,0
lonceng,1,1,3.22994,3.22994,0,1
gereja,1,2,2.92891,2.92891,1,1
panen,1,3,2.75282,2.75282,3,0
luas,1,2,2.92891,2.92891,2,0
lowong,1,1,3.22994,3.22994,1,0
simpuh,1,1,3.22994,3.22994,0,1
residivis,1,1,3.22994,3.22994,0,1
jabung,1,1,3.22994,3.22994,1,0
laki,2,1,3.22994,6.45988,0,1
bobot,1,1,3.22994,3.22994,1,0
sulit,1,1,3.22994,3.22994,0,1
drop,1,1,3.22994,3.22994,0,1
galak,1,1,3.22994,3.22994,1,0
sobat,1,1,3.22994,3.22994,1,0
tunjung,1,1,3.22994,3.22994,1,0
solid,1,1,3.22994,3.22994,1,0
akurat,1,1,3.22994,3.22994,1,0
kucing,2,2,2.92891,5.85782,2,0
surga,1,1,3.22994,3.22994,1,0
progres,1,1,3.22994,3.22994,1,0
rekayasa,1,3,2.75282,2.75282,2,1
jemaah,1,4,2.62788,2.62788,3,1
berangkat,1,2,2.92891,2.92891,2,0
anugerah,1,2,2.92891,2.92891,2,0
konservasi,1,3,2.75282,2.75282,3,0
abrasi,1,3,2.75282,2.75282,3,0
tipu,1,3,2.75282,2.75282,1,2
ricuh,1,20,1.92891,1.92891,1,19
paksa,1,4,2.62788,2.62788,0,4
tembak,1,3,2.75282,2.75282,0,3
terap,1,9,2.27570,2.2757,6,3
tawang,1,3,2.75282,2.75282,1,2
usir,1,2,2.92891,2.92891,0,2
stadion,1,14,2.08381,2.08381,4,10
sup,1,1,3.22994,3.22994,1,0
favorit,1,6,2.45179,2.45179,6,0
hafal,1,1,3.22994,3.22994,1,0
alquran,1,1,3.22994,3.22994,1,0
jinak,1,1,3.22994,3.22994,1,0
bom,1,2,2.92891,2.92891,1,1
juni,1,3,2.75282,2.75282,2,1
suasana,1,1,3.22994,3.22994,0,1
timpa,1,7,2.38484,2.38484,0,7
material,1,1,3.22994,3.22994,0,1
modal,1,2,2.92891,2.92891,2,0
dramatis,1,1,3.22994,3.22994,0,1
gabung,1,1,3.22994,3.22994,0,1
pil,1,1,3.22994,3.22994,0,1
ekstasi,1,3,2.75282,2.75282,0,3
sar,1,1,3.22994,3.22994,0,1
kepang,1,1,3.22994,3.22994,1,0
alternatif,1,1,3.22994,3.22994,1,0
hibur,1,2,2.92891,2.92891,1,1
ampas,1,2,2.92891,2.92891,2,0
aset,1,3,2.75282,2.75282,2,1
koruptor,1,1,3.22994,3.22994,1,0
sah,1,3,2.75282,2.75282,3,0
obat,1,4,2.62788,2.62788,1,3
vitamin,1,1,3.22994,3.22994,1,0
spora,1,1,3.22994,3.22994,0,1
sarasehan,1,1,3.22994,3.22994,1,0
kades,2,1,3.22994,6.45988,1,0
infrastruktur,1,1,3.22994,3.22994,1,0
khalayak,1,1,3.22994,3.22994,1,0
modus,1,3,2.75282,2.75282,0,3
piza,1,1,3.22994,3.22994,1,0
triwulan,1,1,3.22994,3.22994,1,0
triliun,1,3,2.75282,2.75282,1,2
bekuk,1,1,3.22994,3.22994,0,1
otak,1,1,3.22994,3.22994,0,1
kue,1,4,2.62788,2.62788,3,1
lumpur,1,4,2.62788,2.62788,2,2
pentas,1,3,2.75282,2.75282,3,0
karawitan,1,1,3.22994,3.22994,1,0
gambang,1,1,3.22994,3.22994,1,0
transfer,1,1,3.22994,3.22994,1,0
tunggak,1,2,2.92891,2.92891,0,2
waisak,1,1,3.22994,3.22994,1,0
buddha,1,1,3.22994,3.22994,1,0
wihara,1,1,3.22994,3.22994,1,0
kejar,1,1,3.22994,3.22994,0,1
agih,1,1,3.22994,3.22994,0,1
dengue,1,1,3.22994,3.22994,1,0
ludah,1,1,3.22994,3.22994,0,1
gaduh,1,1,3.22994,3.22994,0,1
nikah,2,4,2.62788,5.25576,1,3
tilap,1,1,3.22994,3.22994,0,1
giat,1,2,2.92891,2.92891,2,0
ujung,1,5,2.53097,2.53097,0,5
biksu,1,2,2.92891,2.92891,1,1
ritual,1,1,3.22994,3.22994,0,1
wartawan,1,3,2.75282,2.75282,2,1
lebar,1,1,3.22994,3.22994,1,0
organisasi,1,1,3.22994,3.22994,1,0
tum,1,3,2.75282,2.75282,2,1
majelis,1,1,3.22994,3.22994,1,0
nurani,1,1,3.22994,3.22994,1,0
jajan,1,1,3.22994,3.22994,1,0
administrasi,1,1,3.22994,3.22994,1,0
sensor,1,1,3.22994,3.22994,1,0
sengaja,1,3,2.75282,2.75282,1,2
putar,1,2,2.92891,2.92891,1,1
istirahat,1,4,2.62788,2.62788,2,2
sedekah,1,3,2.75282,2.75282,3,0
dukuh,1,1,3.22994,3.22994,1,0
dalang,1,1,3.22994,3.22994,1,0
ki,1,1,3.22994,3.22994,1,0
nanang,1,1,3.22994,3.22994,1,0
wisnu,1,1,3.22994,3.22994,1,0
mutilasi,1,65,1.41702,1.41702,0,65
motif,1,1,3.22994,3.22994,0,1
dendam,1,6,2.45179,2.45179,0,6
religi,1,1,3.22994,3.22994,1,0
manasik,1,1,3.22994,3.22994,1,0
padat,1,6,2.45179,2.45179,2,4
jasad,1,7,2.38484,2.38484,0,7
keroncong,1,2,2.92891,2.92891,2,0
lulus,1,2,2.92891,2.92891,2,0
imtihan,1,1,3.22994,3.22994,1,0
antusias,1,4,2.62788,2.62788,4,0
gedung,1,1,3.22994,3.22994,1,0
reaksi,1,4,2.62788,2.62788,1,3
lunas,1,1,3.22994,3.22994,1,0
puasa,1,23,1.86821,1.86821,23,0
begal,1,2,2.92891,2.92891,0,2
investor,1,2,2.92891,2.92891,2,0
insentif,1,1,3.22994,3.22994,1,0
pagar,1,2,2.92891,2.92891,0,2
adegan,1,5,2.53097,2.53097,0,5
bos,1,52,1.51393,1.51393,0,52
depot,1,24,1.84973,1.84973,0,24
pelopor,1,1,3.22994,3.22994,1,0
jaksa,1,1,3.22994,3.22994,0,1
resik,2,1,3.22994,6.45988,1,0
baku,1,1,3.22994,3.22994,1,0
laboratorium,1,1,3.22994,3.22994,0,1
alumni,1,1,3.22994,3.22994,1,0
incar,1,1,3.22994,3.22994,0,1
lonjak,1,5,2.53097,2.53097,3,2
janggal,1,3,2.75282,2.75282,0,3
prajurit,1,1,3.22994,3.22994,1,0
versi,1,3,2.75282,2.75282,0,3
kejang,2,2,2.92891,5.85782,0,2
indekos,1,4,2.62788,2.62788,0,4
cekok,1,1,3.22994,3.22994,0,1
autopsi,1,2,2.92891,2.92891,0,2
gulung,1,2,2.92891,2.92891,0,2
forensik,1,2,2.92891,2.92891,0,2
toksin,1,2,2.92891,2.92891,0,2
suci,1,2,2.92891,2.92891,1,1
serobot,1,1,3.22994,3.22994,0,1
lapor,1,6,2.45179,2.45179,0,6
warna,1,4,2.62788,2.62788,3,1
misteri,1,1,3.22994,3.22994,0,1
lemas,1,1,3.22994,3.22994,0,1
wajar,1,2,2.92891,2.92891,0,2
distributor,1,1,3.22994,3.22994,0,1
kerap,1,2,2.92891,2.92891,0,2
muhammad,1,1,3.22994,3.22994,1,0
duta,1,1,3.22994,3.22994,1,0
kaya,1,2,2.92891,2.92891,2,0
promosi,1,1,3.22994,3.22994,1,0
pariwisata,1,2,2.92891,2.92891,2,0
canang,1,1,3.22994,3.22994,1,0
bahari,1,1,3.22994,3.22994,1,0
rutin,1,2,2.92891,2.92891,2,0
rahman,1,4,2.62788,2.62788,3,1
ibadah,1,3,2.75282,2.75282,3,0
geram,1,1,3.22994,3.22994,0,1
koboi,1,1,3.22994,3.22994,0,1
kolaborasi,1,2,2.92891,2.92891,2,0
kurikulum,1,1,3.22994,3.22994,1,0
galon,1,12,2.15076,2.15076,0,12
mundur,1,5,2.53097,2.53097,1,4
jember,1,1,3.22994,3.22994,1,0
eksekutif,1,1,3.22994,3.22994,1,0
aktor,1,1,3.22994,3.22994,1,0
senior,1,1,3.22994,3.22994,1,0
tarzan,1,1,3.22994,3.22994,1,0
sali,1,2,2.92891,2.92891,0,2
sesal,1,4,2.62788,2.62788,0,4
alibi,1,1,3.22994,3.22994,0,1
ekspor,1,1,3.22994,3.22994,1,0
as,1,1,3.22994,3.22994,1,0
terang,1,1,3.22994,3.22994,0,1
konsisten,1,2,2.92891,2.92891,1,1
pakar,1,1,3.22994,3.22994,0,1
tanggung,1,1,3.22994,3.22994,0,1
psikolog,1,2,2.92891,2.92891,0,2
cerdas,1,4,2.62788,2.62788,2,2
kriminalisasi,1,1,3.22994,3.22994,1,0
lebaran,1,21,1.90772,1.90772,16,5
rencana,1,1,3.22994,3.22994,0,1
sewa,1,3,2.75282,2.75282,0,3
kriminolog,1,2,2.92891,2.92891,0,2
paham,1,2,2.92891,2.92891,1,1
karyawan,1,6,2.45179,2.45179,0,6
sadis,1,1,3.22994,3.22994,0,1
kelas,1,1,3.22994,3.22994,1,0
zero,1,1,3.22994,3.22994,1,0
teknisi,1,6,2.45179,2.45179,1,5
lift,1,8,2.32685,2.32685,1,7
kantor,1,9,2.27570,2.2757,1,8
kayak,1,1,3.22994,3.22994,0,1
diam,1,3,2.75282,2.75282,0,3
tampang,1,2,2.92891,2.92891,0,2
open,1,2,2.92891,2.92891,0,2
senyum,1,1,3.22994,3.22994,0,1
ambil,1,2,2.92891,2.92891,1,1
mabuk,1,2,2.92891,2.92891,0,2
tawa,1,1,3.22994,3.22994,0,1
cewek,1,1,3.22994,3.22994,0,1
majikan,1,1,3.22994,3.22994,0,1
habis,1,1,3.22994,3.22994,0,1
rantau,1,1,3.22994,3.22994,0,1
santun,1,2,2.92891,2.92891,2,0
tua,1,2,2.92891,2.92891,1,1
komunikasi,1,2,2.92891,2.92891,1,1
pingsan,1,2,2.92891,2.92891,0,2
tragedi,1,1,3.22994,3.22994,0,1
marah,1,2,2.92891,2.92891,0,2
rilis,1,1,3.22994,3.22994,0,1
tragis,1,2,2.92891,2.92891,0,2
prosedur,1,1,3.22994,3.22994,0,1
demo,1,8,2.32685,2.32685,0,8
dewan,1,1,3.22994,3.22994,0,1
hadiah,1,2,2.92891,2.92891,1,1
halalbihalal,1,1,3.22994,3.22994,1,0
erat,1,2,2.92891,2.92891,2,0
jalin,1,1,3.22994,3.22994,1,0
ida,1,2,2.92891,2.92891,0,2
info,1,3,2.75282,2.75282,1,2
sarung,1,4,2.62788,2.62788,3,1
gaya,1,1,3.22994,3.22994,1,0
tebing,1,3,2.75282,2.75282,0,3
longsor,1,11,2.18855,2.18855,1,10
atribut,1,2,2.92891,2.92891,2,0
ari,1,2,2.92891,2.92891,2,0
zakat,1,1,3.22994,3.22994,1,0
pawai,1,2,2.92891,2.92891,2,0
cabut,1,2,2.92891,2.92891,0,2
joget,1,1,3.22994,3.22994,1,0
bareng,1,2,2.92891,2.92891,2,0
gudang,1,4,2.62788,2.62788,0,4
rosok,1,1,3.22994,3.22994,0,1
potret,1,1,3.22994,3.22994,1,0
fitri,1,4,2.62788,2.62788,4,0
selenggara,1,1,3.22994,3.22994,1,0
sandi,1,1,3.22994,3.22994,1,0
panggung,1,1,3.22994,3.22994,1,0
sinyal,1,4,2.62788,2.62788,4,0
koalisi,1,1,3.22994,3.22994,1,0
udik,1,27,1.79857,1.79857,22,5
senang,1,1,3.22994,3.22994,1,0
bongkar,1,4,2.62788,2.62788,0,4
lapak,1,3,2.75282,2.75282,0,3
kanjeng,1,1,3.22994,3.22994,0,1
ruas,1,2,2.92891,2.92891,1,1
roda,1,1,3.22994,3.22994,1,0
armada,1,1,3.22994,3.22994,1,0
sanjung,1,1,3.22994,3.22994,1,0
duet,1,1,3.22994,3.22994,1,0
rongsok,1,1,3.22994,3.22994,0,1
cuti,1,2,2.92891,2.92891,2,0
tarif,1,3,2.75282,2.75282,2,1
trans,1,4,2.62788,2.62788,3,1
gerbang,1,4,2.62788,2.62788,3,1
bilang,1,1,3.22994,3.22994,1,0
destinasi,1,2,2.92891,2.92891,2,0
sri,1,1,3.22994,3.22994,1,0
arah,1,3,2.75282,2.75282,3,0
lengang,1,1,3.22994,3.22994,1,0
bombai,1,1,3.22994,3.22994,0,1
gila,2,1,3.22994,6.45988,0,1
bungkus,1,3,2.75282,2.75282,1,2
paket,1,2,2.92891,2.92891,2,0
belu,1,1,3.22994,3.22994,1,0
tenggara,1,1,3.22994,3.22994,1,0
bebas,1,2,2.92891,2.92891,0,2
lindung,1,2,2.92891,2.92891,1,1
kayu,1,2,2.92891,2.92891,2,0
dekorasi,1,1,3.22994,3.22994,1,0
interior,1,1,3.22994,3.22994,1,0
nan,1,1,3.22994,3.22994,1,0
patroli,1,1,3.22994,3.22994,1,0
produsen,1,1,3.22994,3.22994,0,1
petas,1,2,2.92891,2.92891,0,2
kam,1,1,3.22994,3.22994,0,1
april,1,33,1.71142,1.71142,33,0
maskapai,1,1,3.22994,3.22994,1,0
area,1,9,2.27570,2.2757,3,6
imsak,1,20,1.92891,1.92891,20,0
subuh,1,16,2.02582,2.02582,16,0
jumat,1,10,2.22994,2.22994,8,2
idulfitri,1,1,3.22994,3.22994,1,0
kamis,1,7,2.38484,2.38484,7,0
bahaya,1,3,2.75282,2.75282,0,3
parkir,1,2,2.92891,2.92891,0,2
bahu,1,2,2.92891,2.92891,0,2
kilometer,1,1,3.22994,3.22994,1,0
setir,1,1,3.22994,3.22994,1,0
bingung,1,1,3.22994,3.22994,0,1
batang,1,2,2.92891,2.92891,2,0
cemas,1,1,3.22994,3.22994,1,0
wakil,1,2,2.92891,2.92891,2,0
ramadan,1,26,1.81496,1.81496,22,4
takjil,1,7,2.38484,2.38484,5,2
botol,1,1,3.22994,3.22994,0,1
knalpot,1,1,3.22994,3.22994,0,1
mercon,1,1,3.22994,3.22994,0,1
senin,1,6,2.45179,2.45179,6,0
gerak,1,4,2.62788,2.62788,3,1
hibah,1,1,3.22994,3.22994,0,1
syarat,1,1,3.22994,3.22994,1,0
kandung,1,2,2.92891,2.92891,0,2
macet,1,2,2.92891,2.92891,1,1
kerah,1,1,3.22994,3.22994,1,0
sahur,1,3,2.75282,2.75282,2,1
pemali,1,1,3.22994,3.22994,1,0
molor,1,1,3.22994,3.22994,1,0
titik,1,1,3.22994,3.22994,0,1
sedia,1,1,3.22994,3.22994,1,0
minggu,1,3,2.75282,2.75282,3,0
minibus,1,2,2.92891,2.92891,0,2
sabtu,1,4,2.62788,2.62788,4,0
inflasi,1,4,2.62788,2.62788,3,1
bazar,1,1,3.22994,3.22994,1,0
pulang,1,3,2.75282,2.75282,0,3
top,1,4,2.62788,2.62788,3,1
visum,1,1,3.22994,3.22994,0,1
prihatin,1,1,3.22994,3.22994,1,0
rektor,1,2,2.92891,2.92891,2,0
impit,1,1,3.22994,3.22994,0,1
visitasi,1,1,3.22994,3.22994,1,0
advokat,1,1,3.22994,3.22994,1,0
isu,1,6,2.45179,2.45179,4,2
mega,1,4,2.62788,2.62788,3,1
hancur,1,2,2.92891,2.92891,0,2
enam,1,3,2.75282,2.75282,0,3
nenek,1,2,2.92891,2.92891,0,2
dusun,1,2,2.92891,2.92891,0,2
kabar,1,2,2.92891,2.92891,1,1
roboh,1,3,2.75282,2.75282,0,3
marga,1,2,2.92891,2.92891,2,0
skenario,1,2,2.92891,2.92891,2,0
kebut,1,1,3.22994,3.22994,1,0
adati,1,1,3.22994,3.22994,1,0
kode,1,1,3.22994,3.22994,1,0
suap,1,1,3.22994,3.22994,0,1
taksir,1,1,3.22994,3.22994,0,1
bahagia,1,1,3.22994,3.22994,1,0
iring,2,2,2.92891,5.85782,2,0
toko,1,2,2.92891,2.92891,2,0
sersan,1,1,3.22994,3.22994,0,1
hanif,1,1,3.22994,3.22994,0,1
ikat,1,1,3.22994,3.22994,1,0
jari,1,1,3.22994,3.22994,1,0
kelar,1,1,3.22994,3.22994,1,0
muslim,1,2,2.92891,2.92891,2,0
pastel,1,2,2.92891,2.92891,2,0
gelap,1,1,3.22994,3.22994,0,1
rembang,1,1,3.22994,3.22994,0,1
pinang,1,1,3.22994,3.22994,1,0
musyawarah,1,2,2.92891,2.92891,2,0
visualisasi,1,1,3.22994,3.22994,1,0
salib,1,1,3.22994,3.22994,1,0
sengsara,1,1,3.22994,3.22994,1,0
kristus,1,1,3.22994,3.22994,1,0
nuansa,1,1,3.22994,3.22994,1,0
ati,1,2,2.92891,2.92891,2,0
bubur,1,2,2.92891,2.92891,2,0
pekojan,1,1,3.22994,3.22994,1,0
kursi,1,2,2.92891,2.92891,2,0
bukit,1,1,3.22994,3.22994,1,0
senja,1,1,3.22994,3.22994,1,0
bab,1,1,3.22994,3.22994,0,1
sembarang,1,1,3.22994,3.22994,0,1
metode,1,1,3.22994,3.22994,1,0
omnibus,1,1,3.22994,3.22994,1,0
tindih,1,1,3.22994,3.22994,1,0
masak,1,2,2.92891,2.92891,2,0
saji,1,4,2.62788,2.62788,4,0
korsleting,1,1,3.22994,3.22994,0,1
hangus,1,1,3.22994,3.22994,0,1
maret,1,10,2.22994,2.22994,10,0
zat,1,1,3.22994,3.22994,0,1
jambret,1,1,3.22994,3.22994,0,1
semangat,1,2,2.92891,2.92891,2,0
luap,1,2,2.92891,2.92891,0,2
umur,1,1,3.22994,3.22994,0,1
syekh,1,1,3.22994,3.22994,0,1
kelontong,1,1,3.22994,3.22994,1,0
segel,1,3,2.75282,2.75282,1,2
colong,1,1,3.22994,3.22994,0,1
mahkamah,1,1,3.22994,3.22994,0,1
manajemen,1,1,3.22994,3.22994,0,1
terjang,1,4,2.62788,2.62788,0,4
hanyut,1,1,3.22994,3.22994,0,1
akhirat,1,1,3.22994,3.22994,1,0
multimedia,1,1,3.22994,3.22994,1,0
duka,1,1,3.22994,3.22994,0,1
ajudan,1,2,2.92891,2.92891,0,2
almarhum,1,1,3.22994,3.22994,0,1
azan,1,1,3.22994,3.22994,1,0
magrib,1,1,3.22994,3.22994,1,0
rakyat,1,2,2.92891,2.92891,2,0
inggris,1,2,2.92891,2.92891,2,0
teks,1,1,3.22994,3.22994,1,0
jemaat,1,1,3.22994,3.22994,1,0
unit,1,1,3.22994,3.22994,1,0
ambulans,1,1,3.22994,3.22994,1,0
panser,1,1,3.22994,3.22994,1,0
layat,1,1,3.22994,3.22994,0,1
layar,1,1,3.22994,3.22994,1,0
alun,2,1,3.22994,6.45988,0,1
kudus,1,2,2.92891,2.92891,1,1
dugder,1,6,2.45179,2.45179,4,2
manusia,1,1,3.22994,3.22994,0,1
plafon,1,1,3.22994,3.22994,0,1
kosong,1,2,2.92891,2.92891,1,1
dermaga,1,2,2.92891,2.92891,2,0
etika,1,1,3.22994,3.22994,1,0
konten,1,1,3.22994,3.22994,1,0
kreator,1,1,3.22994,3.22994,1,0
gadai,1,1,3.22994,3.22994,0,1
lagu,2,1,3.22994,6.45988,1,0
produksi,1,2,2.92891,2.92891,2,0
gebyur,1,1,3.22994,3.22994,1,0
sandar,1,1,3.22994,3.22994,1,0
robot,1,1,3.22994,3.22994,1,0
gamelan,2,1,3.22994,6.45988,1,0
tabuh,1,1,3.22994,3.22994,1,0
otomatis,1,1,3.22994,3.22994,1,0
nostalgia,1,1,3.22994,3.22994,1,0
kapon,1,1,3.22994,3.22994,1,0
kudap,1,1,3.22994,3.22994,1,0
animasi,1,4,2.62788,2.62788,4,0
turis,1,1,3.22994,3.22994,0,1
beres,1,1,3.22994,3.22994,1,0
rangkak,1,1,3.22994,3.22994,0,1
ikhlas,1,1,3.22994,3.22994,1,0
erupsi,1,1,3.22994,3.22994,0,1
rapi,1,1,3.22994,3.22994,0,1
pikap,1,1,3.22994,3.22994,0,1
universal,1,1,3.22994,3.22994,1,0
peta,1,1,3.22994,3.22994,1,0
abu,1,1,3.22994,3.22994,0,1
debu,1,1,3.22994,3.22994,0,1
deteksi,1,1,3.22994,3.22994,0,1
gadang,1,1,3.22994,3.22994,0,1
klitik,1,1,3.22994,3.22994,0,1
solusi,1,2,2.92891,2.92891,1,1
blokir,1,1,3.22994,3.22994,0,1
korps,1,1,3.22994,3.22994,1,0
bi,1,1,3.22994,3.22994,1,0
kelompok,1,2,2.92891,2.92891,1,1
sadar,1,1,3.22994,3.22994,1,0
pugar,1,1,3.22994,3.22994,1,0
ulama,1,2,2.92891,2.92891,2,0
darat,1,1,3.22994,3.22994,1,0
nyaman,1,1,3.22994,3.22994,1,0
pola,1,1,3.22994,3.22994,1,0
resesi,1,1,3.22994,3.22994,1,0
tantang,1,1,3.22994,3.22994,1,0
bandeng,1,3,2.75282,2.75282,3,0
presto,1,3,2.75282,2.75282,3,0
sambal,1,1,3.22994,3.22994,1,0
durian,1,4,2.62788,2.62788,4,0
mengkal,1,1,3.22994,3.22994,1,0
kinerja,1,2,2.92891,2.92891,2,0
janji,1,2,2.92891,2.92891,0,2
garam,1,1,3.22994,3.22994,0,1
gondol,1,1,3.22994,3.22994,0,1
instruksi,1,1,3.22994,3.22994,0,1
rujuk,1,1,3.22994,3.22994,1,0
pungli,1,1,3.22994,3.22994,0,1
bintara,1,1,3.22994,3.22994,0,1
telan,1,1,3.22994,3.22994,1,0
teken,1,1,3.22994,3.22994,1,0
gawang,1,1,3.22994,3.22994,0,1
sambung,1,1,3.22994,3.22994,1,0
mancanegara,1,1,3.22994,3.22994,1,0
bubar,1,1,3.22994,3.22994,1,0
koordinator,1,5,2.53097,2.53097,1,4
maki,1,2,2.92891,2.92891,0,2
selundup,1,2,2.92891,2.92891,0,2
mewah,1,2,2.92891,2.92891,0,2
gajah,1,3,2.75282,2.75282,1,2
pasien,1,1,3.22994,3.22994,0,1
sultan,1,1,3.22994,3.22994,0,1
mayoritas,1,1,3.22994,3.22994,0,1
bendi,1,2,2.92891,2.92891,0,2
tajam,1,1,3.22994,3.22994,1,0
pepet,1,1,3.22994,3.22994,1,0
pusat,1,1,3.22994,3.22994,1,0
pandemi,1,1,3.22994,3.22994,1,0
digitalisasi,1,1,3.22994,3.22994,1,0
gejala,1,1,3.22994,3.22994,0,1
raib,1,1,3.22994,3.22994,0,1
oknum,1,2,2.92891,2.92891,0,2
istimewa,1,1,3.22994,3.22994,1,0
vide,1,1,3.22994,3.22994,1,0
salmon,1,1,3.22994,3.22994,1,0
ukir,1,1,3.22994,3.22994,1,0
cabang,1,1,3.22994,3.22994,1,0
panah,1,1,3.22994,3.22994,1,0
sangkur,1,1,3.22994,3.22994,0,1
getas,1,1,3.22994,3.22994,0,1
dinding,1,1,3.22994,3.22994,0,1
ambrol,1,1,3.22994,3.22994,0,1
nasib,1,1,3.22994,3.22994,1,0
kulon,1,1,3.22994,3.22994,0,1
rendam,1,2,2.92891,2.92891,0,2
tanggul,1,5,2.53097,2.53097,1,4
jebol,1,1,3.22994,3.22994,0,1
tamu,1,2,2.92891,2.92891,0,2
puruk,1,1,3.22994,3.22994,1,0
ban,1,1,3.22994,3.22994,1,0
induk,1,1,3.22994,3.22994,0,1
drastis,1,1,3.22994,3.22994,0,1
selaras,1,1,3.22994,3.22994,1,0
yoga,1,1,3.22994,3.22994,1,0
komisi,1,1,3.22994,3.22994,1,0
rawit,1,1,3.22994,3.22994,0,1
bulu,1,1,3.22994,3.22994,0,1
jeli,1,1,3.22994,3.22994,0,1
legislatif,1,1,3.22994,3.22994,1,0
tunda,1,3,2.75282,2.75282,0,3
nyali,1,1,3.22994,3.22994,1,0
fokus,1,3,2.75282,2.75282,3,0
imigrasi,1,1,3.22994,3.22994,1,0
pot,1,1,3.22994,3.22994,1,0
ikon,1,1,3.22994,3.22994,1,0
senapan,1,2,2.92891,2.92891,0,2
angin,1,2,2.92891,2.92891,0,2
pelatuk,1,1,3.22994,3.22994,0,1
jenguk,1,1,3.22994,3.22994,1,0
kondusif,1,3,2.75282,2.75282,1,2
sayung,1,1,3.22994,3.22994,1,0
dinar,1,8,2.32685,2.32685,1,7
ungsi,1,1,3.22994,3.22994,0,1
deras,1,2,2.92891,2.92891,0,2
betina,1,2,2.92891,2.92891,0,2
inspirasi,1,2,2.92891,2.92891,2,0
ginjal,1,1,3.22994,3.22994,0,1
bandang,1,3,2.75282,2.75282,0,3
permanen,1,2,2.92891,2.92891,0,2
banding,1,1,3.22994,3.22994,0,1
simulator,1,2,2.92891,2.92891,2,0
teknologi,1,1,3.22994,3.22994,1,0
virtual,1,2,2.92891,2.92891,2,0
bas,1,1,3.22994,3.22994,1,0
komikus,1,1,3.22994,3.22994,1,0
komik,1,1,3.22994,3.22994,1,0
jumbo,1,1,3.22994,3.22994,1,0
februari,1,1,3.22994,3.22994,1,0
pes,1,1,3.22994,3.22994,1,0
antuk,1,1,3.22994,3.22994,0,1
bugar,1,1,3.22994,3.22994,1,0
kencang,1,1,3.22994,3.22994,1,0
bupati,1,1,3.22994,3.22994,1,0
nomor,1,1,3.22994,3.22994,1,0
punggung,1,1,3.22994,3.22994,1,0
sketsa,1,1,3.22994,3.22994,1,0
donor,1,1,3.22994,3.22994,1,0
awet,1,1,3.22994,3.22994,1,0
rembes,1,1,3.22994,3.22994,0,1
komite,1,4,2.62788,2.62788,2,2
pengkol,1,1,3.22994,3.22994,0,1
ad,1,3,2.75282,2.75282,1,2
ya,1,1,3.22994,3.22994,1,0
bentrok,1,3,2.75282,2.75282,1,2
aksa,1,1,3.22994,3.22994,0,1
rapat,1,1,3.22994,3.22994,0,1
genting,1,1,3.22994,3.22994,0,1
situasi,1,2,2.92891,2.92891,0,2
halau,1,1,3.22994,3.22994,0,1
muncul,1,2,2.92891,2.92891,1,1
gigit,1,1,3.22994,3.22994,0,1
usung,1,1,3.22994,3.22994,1,0
konsep,1,2,2.92891,2.92891,2,0
cokelat,1,2,2.92891,2.92891,1,1
vonis,1,1,3.22994,3.22994,1,0
roti,1,1,3.22994,3.22994,1,0
belanda,1,1,3.22994,3.22994,1,0
pustaka,1,1,3.22994,3.22994,1,0
gratifikasi,1,1,3.22994,3.22994,1,0
bibir,1,1,3.22994,3.22994,1,0
sumbing,1,1,3.22994,3.22994,1,0
diabetes,1,1,3.22994,3.22994,0,1
abai,1,1,3.22994,3.22994,1,0
curah,1,1,3.22994,3.22994,1,0
posisi,1,1,3.22994,3.22994,1,0
tidur,1,1,3.22994,3.22994,1,0
kuota,1,1,3.22994,3.22994,1,0
lukis,2,2,2.92891,5.85782,2,0
haul,1,1,3.22994,3.22994,1,0
abah,1,1,3.22994,3.22994,1,0
lurus,1,1,3.22994,3.22994,1,0
netral,1,1,3.22994,3.22994,1,0
seminar,1,1,3.22994,3.22994,1,0
kondang,1,1,3.22994,3.22994,1,0
nyentrik,1,1,3.22994,3.22994,1,0
hormat,1,1,3.22994,3.22994,1,0
porsi,1,1,3.22994,3.22994,0,1
liar,1,1,3.22994,3.22994,0,1
kerumun,1,1,3.22994,3.22994,0,1
lalat,1,1,3.22994,3.22994,0,1
ombak,1,3,2.75282,2.75282,0,3
tagih,1,1,3.22994,3.22994,0,1
canggih,1,1,3.22994,3.22994,1,0
cap,1,2,2.92891,2.92891,2,0
quran,1,1,3.22994,3.22994,1,0
implementasi,1,1,3.22994,3.22994,1,0
profil,1,1,3.22994,3.22994,1,0
lontong,1,1,3.22994,3.22994,1,0
imlek,1,1,3.22994,3.22994,1,0
tempel,1,1,3.22994,3.22994,1,0
melek,1,1,3.22994,3.22994,1,0
kawin,1,1,3.22994,3.22994,1,0
erang,1,1,3.22994,3.22994,0,1
tes,1,1,3.22994,3.22994,1,0
wawancara,1,1,3.22994,3.22994,1,0
asli,1,1,3.22994,3.22994,1,0
randu,1,1,3.22994,3.22994,1,0
babon,1,1,3.22994,3.22994,0,1
hujung,1,1,3.22994,3.22994,1,0
tanggulang,1,1,3.22994,3.22994,0,1
permen,1,1,3.22994,3.22994,0,1
bisik,1,1,3.22994,3.22994,1,0
suka,1,1,3.22994,3.22994,1,0
susul,1,1,3.22994,3.22994,0,1
tepis,1,1,3.22994,3.22994,0,1
renggang,1,1,3.22994,3.22994,0,1
bang,1,1,3.22994,3.22994,1,0
sunti,1,1,3.22994,3.22994,1,0
euforia,1,1,3.22994,3.22994,1,0
minim,1,1,3.22994,3.22994,0,1
picu,1,1,3.22994,3.22994,0,1
aula,1,1,3.22994,3.22994,1,0
politis,1,2,2.92891,2.92891,2,0
politikus,1,1,3.22994,3.22994,1,0
runtuh,1,1,3.22994,3.22994,1,0
jera,1,1,3.22994,3.22994,1,0
gangster,1,1,3.22994,3.22994,1,0

Total Document Training Sentimen Positive,3638
Total Document Training Sentimen Negative,3721
